000000G00000000
572525A56777773
94FBCB99C777772
C777728C246257A
57772D77B5B994B
957399467B4BD72
9C77AD7B525295A
D7729957B999998
952998953CB98C2
9999C7BC777F77A
CB8C7777772477B
0000000000H0000